### WestEur
GER = "countries/WestEur.txt" # Germany
SWE = "countries/WestEur.txt" # Sweden
FRA = "countries/WestEur.txt" # France
LUX = "countries/WestEur.txt" # Luxemburg
BEL = "countries/WestEur.txt" # Belgium
HOL = "countries/WestEur.txt" # Holland
AUS = "countries/WestEur.txt" # Austria
ITA = "countries/WestEur.txt" # Italy
SPA = "countries/WestEur.txt" # Spain
SWI = "countries/WestEur.txt" # Switzerland
GRE = "countries/WestEur.txt" # Greece
NOR = "countries/WestEur.txt" # Norway
DEN = "countries/WestEur.txt" # Denmark
POR = "countries/WestEur.txt" # Portugal
FIN = "countries/WestEur.txt" # Finland
IRE = "countries/WestEur.txt" # Ireland
USA = "countries/WestEur.txt" # USA
CSA = "countries/WestEur.txt" # CSA
ICE = "countries/WestEur.txt" # Iceland
WGR = "countries/German.txt" # West Germany
DDR = "countries/German.txt" # East Germany
ISR = "countries/WestEur.txt" # Israel
MLT = "countries/WestEur.txt" # Malta

### Commonw
ENG = "countries/Commonw.txt" # United Kingdom
AST = "countries/Commonw.txt" # Australia
CAN = "countries/Commonw.txt" # Canada
NZL = "countries/Commonw.txt" # New Zealand
SAF = "countries/Commonw.txt" # South Africa
RAJ = "countries/Commonw.txt" # British Raj
NIR = "countries/Commonw.txt" # Northern Ireland
SCO = "countries/Commonw.txt" # Scotland
WAL = "countries/Commonw.txt" # Wales

### EastEur
SOV = "countries/EastEur.txt" # Soviet Union
CZE = "countries/EastEur.txt" # Czechoslovakia
POL = "countries/EastEur.txt" # Poland
LIT = "countries/EastEur.txt" # Lithuania
EST = "countries/EastEur.txt" # Estonia
LAT = "countries/EastEur.txt" # Latvia
ROM = "countries/EastEur.txt" # Romania
SER = "countries/EastEur.txt" # Serbia
TUR = "countries/EastEur.txt" # Turkey
ALB = "countries/EastEur.txt" # Albania
BUL = "countries/EastEur.txt" # Bulgaria
HUN = "countries/EastEur.txt" # Hungary
SLO = "countries/EastEur.txt" # Slovakia
CRO = "countries/EastEur.txt" # Croatia
MNT = "countries/EastEur.txt" # Montenegro
UKR = "countries/EastEur.txt" # Ukraine
GEO = "countries/EastEur.txt" # Georgia
ARM = "countries/EastEur.txt" # Armenia
BLR = "countries/EastEur.txt" # Belarus
CYP = "countries/EastEur.txt" # Cyprus
BOS = "countries/EastEur.txt" # Bosnia
SLV = "countries/EastEur.txt" # Slovenia

### MidEast
MOR = "countries/African.txt" # Morocco
ALG = "countries/African.txt" # Algeria
AFG = "countries/MidEast.txt" # Afghanistan
IRQ = "countries/MidEast.txt" # Iraq
PER = "countries/MidEast.txt" # Persia
SAU = "countries/MidEast.txt" # Saudi Arabia
YEM = "countries/MidEast.txt" # Yeman
OMA = "countries/MidEast.txt" # Oman
LEB = "countries/MidEast.txt" # Lebanon
JOR = "countries/MidEast.txt" # Jordan
SYR = "countries/MidEast.txt" # Syria
EGY = "countries/MidEast.txt" # Egypt
LBA = "countries/MidEast.txt" # Libya
PAL = "countries/MidEast.txt" # Palestine
KAZ = "countries/GenericRus.txt" # Kazakhstan
AZR = "countries/MidEast.txt" # Azerbaijan
PAK = "countries/MidEast.txt" # Pakistan
QAT = "countries/MidEast.txt" # Qatar
BHR = "countries/MidEast.txt" # Bahrain
UAE = "countries/MidEast.txt" # United Arab Emirates
KUW = "countries/MidEast.txt" # Kuwait
TUN = "countries/MidEast.txt" # Tunisia
KUR = "countries/MidEast.txt" # Tunisia

### SouthAm
ARG = "countries/SouthAm.txt" # Argentina
BOL = "countries/SouthAm.txt" # Bolivia
BRA = "countries/SouthAm.txt" # Brazil
CHL = "countries/SouthAm.txt" # Chile
COL = "countries/SouthAm.txt" # Colombia
COS = "countries/SouthAm.txt" # Costa Rica
ECU = "countries/SouthAm.txt" # Ecuador
ELS = "countries/SouthAm.txt" # El Salvador
GUA = "countries/SouthAm.txt" # Guatemla
HON = "countries/SouthAm.txt" # Honduras
MEX = "countries/SouthAm.txt" # Mexico
NIC = "countries/SouthAm.txt" # Nicaragua
PAN = "countries/SouthAm.txt" # Panama
PRU = "countries/SouthAm.txt" # Peru
URG = "countries/SouthAm.txt" # Uruguay
VEN = "countries/SouthAm.txt" # Venezula
PAR = "countries/SouthAm.txt" # Paraguay
CUB = "countries/SouthAm.txt" # Cuba
DOM = "countries/SouthAm.txt" # Dominican Republic
HAI = "countries/SouthAm.txt" # Haiti
BAH = "countries/SouthAm.txt" # Bahamas
BLZ = "countries/SouthAm.txt" # Belize
CRC = "countries/SouthAm.txt" # Curacao
GDL = "countries/SouthAm.txt" # Guadeloupe
GYA = "countries/SouthAm.txt" # Guyana
JAM = "countries/SouthAm.txt" # Jamaica
SUR = "countries/SouthAm.txt" # Suriname
TRI = "countries/SouthAm.txt" # Trinidad and Tobago
BAS = "countries/SouthAm.txt" # British Antilles
CAY = "countries/SouthAm.txt" # Cayenne
MLD = "countries/SouthAm.txt" # Maldives

### Asian
BHU = "countries/Asian.txt" # Bhutan
CHI = "countries/Asian.txt" # China
JAP = "countries/Asian.txt" # Japan
KOR = "countries/Asian.txt" # Korea
NEP = "countries/Asian.txt" # Nepal
PHI = "countries/Asian.txt" # Philippines
SIA = "countries/Asian.txt" # Siam
#SIK = "countries/Asian.txt" # Sinkiang
TIB = "countries/Asian.txt" # Tibet
#YUN = "countries/Asian.txt" # Yunnan
MON = "countries/Asian.txt" # Mongolia
TAN = "countries/Asian.txt" # Tannu Tuva
VIN = "countries/Asian.txt" # Vietnam
CAM = "countries/Asian.txt" # Cambodia
MAL = "countries/Asian.txt" # Malaysia
INS = "countries/Asian.txt" # Indonesia
LAO = "countries/Asian.txt" # Laos
#MAN = "countries/Asian.txt" # Manchukou
BAN = "countries/Asian.txt" # Bangladesh
PNG = "countries/Asian.txt" # Papua New Guinea
FIJ = "countries/Asian.txt" # Fiji
SRL = "countries/Asian.txt" # Sri Lanka
SLM = "countries/Asian.txt" # Solomon Islands

### African
SUD = "countries/African.txt" # Sudan
GHA = "countries/Ghana.txt" # Ghana
ETH = "countries/African.txt" # Ethiopia
LIB = "countries/African.txt" # Liberia
ANG = "countries/African.txt" # Angola
MZB = "countries/African.txt" # Mozambique
ZIM = "countries/African.txt" # Zimbabwe
COG = "countries/African.txt" # Congo
KEN = "countries/African.txt" # Kenya
BOT = "countries/African.txt" # Botswana
MAD = "countries/African.txt" # Madagascar
ERI = "countries/African.txt" # Eritrea
DJI = "countries/African.txt" # Djibouti
SOM = "countries/African.txt" # Somalia
UGA = "countries/African.txt" # Uganda
RWA = "countries/African.txt" # Rwanda
BRD = "countries/African.txt" # Burundi
TZN = "countries/African.txt" # Tanzania
ZAM = "countries/African.txt" # Zambia
MLW = "countries/African.txt" # Malawi
GAB = "countries/African.txt" # Gabon
RCG = "countries/African.txt" # Republic of Congo
EQG = "countries/African.txt" # Equatorial Guinea
CMR = "countries/African.txt" # Cameroon
CAR = "countries/African.txt" # Central African Republic
CHA = "countries/African.txt" # Chad
NGA = "countries/African.txt" # Nigeria
DAH = "countries/African.txt" # Dahomey
TOG = "countries/African.txt" # Togo
IVO = "countries/African.txt" # Ivory Coast
VOL = "countries/African.txt" # Upper Volta
MLI = "countries/African.txt" # Mali
SIE = "countries/African.txt" # Sierra Leone
GNA = "countries/African.txt" # Guinea
GNB = "countries/African.txt" # Guinea-Bissau
SEN = "countries/African.txt" # Senegal
GAM = "countries/African.txt" # Gambia
NGR = "countries/African.txt" # Niger
MRT = "countries/African.txt" # Mauritania
NMB = "countries/African.txt" # Namibia
WES = "countries/African.txt" # Western Sahara