###German Sphere
FFR = "countries/WestEur.txt" #Free France
FFP = "countries/WestEur.txt" #Free France Pacific
###India
ASS = "countries/Asian.txt" #Assam
BUR = "countries/Asian.txt" #Burma
BRM = "countries/Asian.txt" #Shan Nation
HYD = "countries/Asian.txt" #Hyderabad
TAM = "countries/Asian.txt" #Tamil
MAR = "countries/Asian.txt" #Marathi
SKM = "countries/Asian.txt" #Sikkim
BEN = "countries/Asian.txt" #Bengal
KSH = "countries/Asian.txt" #Kashmir
CMA = "countries/Asian.txt" #Communist Malaya
RSS = "countries/Asian.txt" #Rashtriya Swayamsevak Sangh

###Former USSR
TRK = "countries/MidEast.txt" #Turkestan
RUS = "countries/EastEur.txt" #Russia
TRV = "countries/GenericRus.txt" #Transvolga
NRI = "countries/GenericRus.txt" #Norilsk
BRY = "countries/GenericRus.txt" #Buryatia
KRA = "countries/GenericRus.txt" #Krasnoyarsk
KCS = "countries/GenericRus.txt" #Krasnoyarsk City State
IRK = "countries/GenericRus.txt" #Irkutusk
NOV = "countries/GenericRus.txt" #Novosibirsk
IDE = "countries/GenericRus.txt" #Idel-Ural
FAR = "countries/GenericRus.txt" #Chita
PRC = "countries/GenericRus.txt" #Chita
SIS = "countries/GenericRus.txt" #Siberian Isles Soviet
TAJ = "countries/Asian.txt" #Tajikistan
KYR = "countries/Asian.txt" #Kyrgyzstan
UZB = "countries/Asian.txt" #Uzbekistan
TRA = "countries/Asian.txt" #Turkmen Red Army
OST = "countries/EastEur.txt" # OstGermany
KAR = "countries/EastEur.txt" #Karelia
PEC = "countries/GenericRus.txt" #Peasant Council
RFP = "countries/EastEur.txt" #Russian Fascist Party
SBR = "countries/GenericRus.txt" #Socialist Buryatia

###Middle East
JLM = "countries/MidEast.txt" #Jerusalem

####GCW
HSS = "countries/German.txt" #Himmlers Reich
HGR = "countries/German.txt" #Heers Reich
BGR = "countries/German.txt" #Bormanns Reich
JGR = "countries/German.txt" #Goebbels Reich
SGR = "countries/German.txt" #Speers Reich
GGR = "countries/German.txt" #Goerings Reich
BGS = "countries/German.txt" #Black Sea Germans
BKU = "countries/German.txt" #Baku
PET = "countries/German.txt" #Petersburg
STR = "countries/German.txt" #Astrakhan
WSP = "countries/German.txt" #Arkhangelsk
RGO = "countries/German.txt" #ReichskommissariatGotenland
SBA = "countries/German.txt" #WestBanat
ROS = "countries/German.txt" #ReichskommissariatOstland
RUK = "countries/German.txt" #ReichskommissariatUkraine
RMO = "countries/German.txt" #ReichskommissariatMoskowien
RKA = "countries/German.txt" #ReichskommissariatKaukasien
RTU = "countries/German.txt" #ReichskommissariatTurkestan
RFA = "countries/German.txt" #ReichskommissariatFranken
MTA = "countries/German.txt" #Mittelafrika
GGP = "countries/German.txt" #Generalgovernment
SSB = "countries/German.txt" #SS-Staat Burgund
RKN = "countries/German.txt" #RK Netherlands
RKB = "countries/German.txt" #RK Belgen
RKE = "countries/German.txt" #Far East RK
RUR = "countries/German.txt" #Repurpose Russian Warlord
#####OTHER
BAK = "countries/African.txt" #Bakongo
RYK = "countries/Asian.txt" #Ryukyu
HOK = "countries/Asian.txt" #Hokkaido
NHF = "countries/Asian.txt" #NorthHonshu
KYS = "countries/Asian.txt" #Kyushu
SHK = "countries/Asian.txt" #Shikoku
DWP = "countries/Asian.txt" #WestPapua
SAR = "countries/Asian.txt" #Sarawak
KAM = "countries/EastEur.txt" #Kalmykia
MTR = "countries/EastEur.txt" #Mountain Republic
DON = "countries/EastEur.txt" #Don Cossacks
CDA = "countries/EastEur.txt" #Cossack Army
UIA = "countries/EastEur.txt" #Ukraine Collab
UKW = "countries/EastEur.txt" #Ukraine West
URP = "countries/EastEur.txt" #Ukraine Poland
CKR = "countries/EastEur.txt" #Ukraine Cap
SUK = "countries/GenericRus.txt" #Soviet Ukraine
SMO = "countries/GenericRus.txt" #Soviet Moscow
WRM = "countries/EastEur.txt" #Russian Front
RAR = "countries/German.txt" #ReichsautonomieRussland
BQC = "countries/WestEur.txt" #BaqueCountry
PGR = "countries/WestEur.txt" #Prison Germany
ICL = "countries/WestEur.txt" #Occupied Iceland
QUE = "countries/WestEur.txt" #Quebec
ARR = "countries/WestEur.txt" #Dakota
OCN = "countries/WestEur.txt" #Occupied Canada
SPR = "countries/WestEur.txt" #Catalonia
NOG = "countries/EastEur.txt" #Nogai
LZG = "countries/EastEur.txt" #Lezgistan
KMY = "countries/EastEur.txt" #Kumyks
RAC = "countries/GenericRus.txt" #Red Army Cossacks
CAF = "countries/Asian.txt" #Cambodian Armed Forces
RSB = "countries/EastEur.txt" #Moskow Anarchists
RMD = "countries/German.txt" #Moskow Fascists
TMS = "countries/EastEur.txt" #Grigorenko Moskow
AIR = "countries/SouthAm.txt" #Autonomous Indigenous Republics
BLC = "countries/EastEur.txt" #Commie Bulgaria
MCD = "countries/EastEur.txt" #Macedonia
KMV = "countries/Asian.txt" #KMT VIet
GXC = "countries/Asian.txt" #Guangxi
YUN = "countries/Asian.txt" #Yunnan
XSM = "countries/Asian.txt" #Qinghai
SHX = "countries/Asian.txt" #Shanxi
GSU = "countries/Asian.txt" #Gansu
NXN = "countries/Asian.txt" #Ningxia
SIK = "countries/Asian.txt" #Xinjiang
MAN = "countries/Asian.txt" #Manchuria
MEN = "countries/Asian.txt" #Inner Mongolia
KOS = "countries/EastEur.txt" #Autonomous State of Kosovo
CPS = "countries/EastEur.txt" #Croatian Partisan State
DPS = "countries/EastEur.txt" #Dalmatian Partisan State
ISC = "countries/EastEur.txt" #Istrian Slovenian Coalition
TLA = "countries/EastEur.txt" #Thracian Liberation Army
CRE = "countries/EastEur.txt" #Crete
DOE = "countries/EastEur.txt" #Dodecanese
MOL = "countries/EastEur.txt" #Moldova
WCH = "countries/EastEur.txt" #Wallachia
NUK = "countries/EastEur.txt" #Transnistria
BNT = "countries/EastEur.txt" #Special Banat
TRY = "countries/EastEur.txt" #Transylvania
HER = "countries/Crusader Herzegovina.txt" #Crusader Revolt
####USSR CW
ZHU = "countries/EastEur.txt" #ZhukovUnion
KRU = "countries/EastEur.txt" #KruglovRussia
BLG = "countries/EastEur.txt" #BulganinRussia

####Occupation
VIC = "countries/WestEur.txt" #Vichy France
EGL = "countries/WestEur.txt" #England

####Reichskommissariat

#AFRICANNEW#
IEA = "countries/African.txt" #Italian East Africa
KAT = "countries/African.txt" #Katanga
SWA = "countries/African.txt" #Swaziland
LES = "countries/African.txt" #Lesotho
DRF = "countries/African.txt" #Darfur
ARD = "countries/African.txt" #Ardjubania/South Sudan
AZA = "countries/African.txt" #Azawad
BRT = "countries/African.txt" #Barotseland
SAH = "countries/MidEast.txt" #Sahwaria
ZAI = "countries/African.txt" #Zaire
RHD = "countries/WestEur.txt" #Rhodesia
BIA = "countries/African.txt" #Biafra
ZAN = "countries/African.txt" #Zanzibar
ZUL = "countries/African.txt" #Zulu
SP1 = "countries/WestEur.txt" #Spanish Casablanca Protectorate
GRL = "countries/WestEur.txt" #Greenland
FIS = "countries/WestEur.txt" #Faroes
SRK = "countries/WestEur.txt" #Srpsk
ORA = "countries/WestEur.txt" #Oran Free State
SAC = "countries/African.txt" #Saharan Council
BAR = "countries/African.txt" #Barbary Republic
CRA = "countries/Croatian Africa.txt" #Croatian Expedition in Africa